{
  "level0": [
    [1,1,1,1,1,1,1,1,1,1],
    [1,0,0,0,0,0,0,0,0,1],
    [1,0,0,0,0,0,0,0,0,1],
    [1,0,0,0,0,0,0,0,0,1],
    [1,0,3,2,0,1,4,0,0,1],
    [1,0,0,0,0,0,0,0,0,1],
    [1,0,0,0,0,0,0,0,0,1],
    [1,0,0,0,0,0,0,0,0,1],
    [1,0,0,0,0,0,0,0,0,1],
    [1,1,1,1,1,1,1,1,1,1]
  ],
  "level1": [
    [1,1,1,1,1,1,1,1,1,1],
    [1,3,1,0,0,0,0,0,0,1],
    [1,0,1,0,0,0,0,0,0,1],
    [1,0,1,0,0,0,0,0,0,1],
    [1,0,1,0,0,0,0,0,0,1],
    [1,0,1,0,0,1,1,0,1,1],
    [1,0,1,0,0,1,0,0,0,1],
    [1,0,2,0,0,1,0,4,0,1],
    [1,0,1,0,0,1,0,0,0,1],
    [1,1,1,1,1,1,1,1,1,1]
  ],
  "level2": [
    [1,1,1,1,1,1,1,1,1,1],
    [1,0,0,3,0,1,0,0,0,1],
    [1,0,2,1,0,1,0,1,0,1],
    [1,0,0,0,0,0,0,0,0,1],
    [1,1,0,1,1,0,1,1,0,1],
    [1,0,0,0,0,0,0,0,0,1],
    [1,0,1,1,1,0,1,0,0,1],
    [1,0,0,0,0,0,0,0,0,1],
    [1,4,1,0,0,0,1,0,0,1],
    [1,1,1,1,1,1,1,1,1,1]
  ],
  "level3": [
    [1,1,1,1,1,1,1,1,1,1],
    [1,0,0,1,0,0,0,1,0,1],
    [1,0,3,1,0,2,0,0,0,1],
    [1,0,1,1,0,0,0,1,0,1],
    [1,0,0,0,1,0,1,0,0,1],
    [1,0,0,0,0,0,0,0,0,1],
    [1,0,1,1,1,2,1,0,1,1],
    [1,0,0,4,0,0,0,4,0,1],
    [1,0,0,0,0,0,0,0,0,1],
    [1,1,1,1,1,1,1,1,1,1]
  ],
  "level4": [
    [1,1,1,1,1,1,1,1,1,1],
    [1,0,0,1,0,0,0,0,0,1],
    [1,0,2,0,0,1,0,3,0,1],
    [1,0,1,1,0,0,0,0,0,1],
    [1,0,0,4,0,0,0,1,0,1],
    [1,0,0,1,0,1,0,0,0,1],
    [1,0,0,0,0,0,0,0,0,1],
    [1,0,2,0,1,0,0,4,0,1],
    [1,0,0,0,1,0,0,0,0,1],
    [1,1,1,1,1,1,1,1,1,1]
  ],
  "level5": [
    [1,1,1,1,1,1,1,1,1,1],
    [1,1,1,0,0,0,0,0,0,1],
    [1,3,0,0,0,2,0,0,0,1],
    [1,1,1,1,1,2,0,4,0,1],
    [1,1,1,0,0,2,0,0,0,1],
    [1,4,1,1,0,0,0,0,0,1],
    [1,0,1,0,4,0,1,1,1,1],
    [1,0,0,0,2,0,2,0,4,1],
    [1,0,0,0,4,0,0,0,0,1],
    [1,1,1,1,1,1,1,1,1,1]
  ],
  "level6": [
    [1,1,1,1,1,1,1,1,1,1],
    [1,1,1,1,1,1,1,1,1,1],
    [1,0,0,1,4,4,1,0,0,1],
    [1,0,1,1,0,4,1,1,0,1],
    [1,0,1,0,0,2,4,1,0,1],
    [1,0,1,0,0,3,2,1,0,1],
    [1,1,0,0,1,2,2,0,1,1],
    [1,1,0,0,0,0,0,0,1,1],
    [1,1,1,1,1,1,1,1,1,1],
    [1,1,1,1,1,1,1,1,1,1]
  ],
  "level7": [
    [1,1,1,1,1,1,1,1,1,1],
    [1,1,1,1,1,1,1,1,1,1],
    [1,1,0,4,0,2,0,1,1,1],
    [1,1,1,0,2,4,2,0,1,1],
    [1,1,4,4,4,1,0,4,1,1],
    [1,1,0,1,2,0,2,0,1,1],
    [1,1,0,2,0,1,4,2,1,1],
    [1,1,0,3,0,0,0,0,1,1],
    [1,1,1,1,1,1,1,1,1,1],
    [1,1,1,1,1,1,1,1,1,1]
  ],
  "level8": [
    [1,1,1,1,1,1,1,1,1,1],
    [1,1,1,1,1,1,1,1,1,1],
    [1,1,1,1,1,4,0,1,0,1],
    [1,0,2,3,2,2,0,1,1,1],
    [1,4,0,2,1,4,0,4,4,1],
    [1,1,0,4,0,0,0,1,0,1],
    [1,1,0,2,0,2,0,0,0,1],
    [1,1,1,1,1,1,0,0,1,1],
    [1,1,1,1,1,1,1,1,1,1],
    [1,1,1,1,1,1,1,1,1,1]
  ]
}
